11
*
8
*
8,7,1
*
00-8-2
#
06-7-2
#
08-7-3
#
09-7-16
#
01-1-3
#
02-1-2
#
03-1-4
#
04-1-0
#
05-1-09
#
07-1-9
*
00000000000
00000000000
00111000000
00111001110
00111001110
00000001110
00000000000
00000000000
*
00 00 00 00 00 00 00 00 00 06 00
00 00 00 00 00 00 00 00 00 06 00
00 00 09 09 09 00 06 06 06 06 00
00 00 09 09 09 00 06 09 09 09 00
00 00 09 09 09 00 06 09 09 09 00
00 00 00 00 00 00 06 09 09 09 00
00 00 00 06 06 06 06 00 00 00 00
00 00 00 06 00 00 00 00 00 00 00
