11
*
8
*
0
*
00-0-0
#
01-0-1
#
02-0-2
#
03-0-3
#
04-0-4
*
00000000000
00000000000
00111000000
00111001110
00111001110
00000001110
00000000000
00000000000
*
00 00 00 00 00 00 00 00 00 00 00
00 00 00 00 00 00 00 00 00 00 00
00 00 00 00 00 04 00 00 00 00 00
00 00 00 00 00 04 00 00 00 00 04
00 00 00 00 00 04 00 00 00 00 04
00 00 01 01 01 00 00 00 00 00 04
00 00 00 00 00 00 00 01 01 01 00
00 00 00 00 00 00 00 00 00 00 00