11
*
20
*
8,7
*
00-8-2-2
#
01-8-37-0
#
02-8-81-4
#
03-8-97-4
#
04-7-82-4
#
05-7-98-4
#
06-7-27-4
#
07-7-62-1
*
01 01 01 01 01 01 01 01 01 01 01
01 01 02 01 01 01 02 01 01 04 01
06 01 03 01 01 01 03 01 01 05 01
00 00 00 00 00 00 00 00 00 00 00
00 00 00 00 00 00 00 00 00 00 06
00 00 00 00 00 00 00 00 00 00 00
00 00 00 00 00 00 00 00 00 00 00
00 00 00 00 00 00 00 00 00 00 00
00 00 00 00 00 00 00 00 00 00 00
00 00 00 00 00 00 00 00 00 00 00
00 07 07 07 07 00 00 00 00 00 00
00 07 07 07 07 00 00 00 00 00 00
00 07 07 07 07 00 00 00 00 00 00
00 00 00 00 00 00 00 00 00 00 00
00 00 00 00 00 00 00 00 00 00 00
00 00 00 00 00 00 07 07 07 07 00
00 00 00 00 00 00 07 07 07 07 00
00 00 00 00 00 00 07 07 07 07 00
00 00 00 00 00 00 00 00 00 00 00
00 00 00 00 00 00 00 00 00 00 00
*